$ ftp опции адрес_сервера
-A - использовать активный режим во время передачи файлов;
-p - использовать пассивный режим, используется по умолчанию;
-i - отключать интерактивный режим во время передачи файлов;
-n - попытаться использовать автоматический вход;
-e - отключить историю команд;
-v - максимально подробный вывод;
-d - включить режим отладки.
account - отправить серверу свой пароль для авторизации;
append - добавить локальный файл в конец удаленного файла на сервере;
ascii - передавать файлы в кодировке ASCII;
binary - передавать файлы в бинарном формате;
bye - завершить сессию;
cd - перейти в папку;
cdup - перейти в папку уровнем выше;
chmod - изменить права на файл;
delete - удалить файл с сервера;
dir - посмотреть список файлов в папке;
get - скачать файл из сервера на локальную машину;
hash - отображать статус передачи файла;
lcd - сменить рабочую директорию на локальной машине;
ls - список файлов в папке;
mdelete - удалить несколько файлов;
mget - скачать несколько файлов;
mkdir - создать папку;
mput - передать несколько файлов на сервер;
open - подключится к удаленному FTP серверу;
put - передать файл на сервер;
pwd - вывести текущую папку;
recv - то же самое что и get;
rename - переименовать файл на сервере;
rmdir - удалить папку;
size - узнать размер файла;
user - авторизоваться на сервере.